Hoa Lạc Vô Ngân · Tát Đỉnh Đỉnh
Tay Trái Chỉ Trăng
TRANG - Và Khi Ta Ngả Nghiêng
Tùng - nguyên vẹn
Thịnh Suy - Mai Mình Xa
Dfoxie37 - Mai Về
Olew - Hãy gặp em trước khi em 25
Madihu - Thôi hẹn em
Obito - Hà Nội
Dab - overtired
Ronboogz - nhắn nhủ
GREY D - dự báo thời tiết hôm nay mưa
Lê Hiếu - Ngày Mai Em Đi
Táo - 2 5
Chillies - Mascara
14 Casper - bao tiền một mớ bình yên?
1nG - Giong Nhu Mua Thu
Thịnh Suy - Chết Trong Em
SIVAN - haydeanhduoccungemdau
Khải - Chỉ Là Muốn Nói
Vũ Cát Tường - Mơ
PC - 10 Ngàn Năm
Hào - Ta Đã Từng Yêu Nhau Chưa
ERIK - Lac Nhau Co Phai Muon Doi (Music From “Cho Em Den Ngay Mai”)
Reddy - Thì Thôi
Thái Đinh - Là Em
TRANG - Chưa Được Yêu Như Thế
D Blue - Em Chưa Giấu Anh Điều Gì
Tùa - Điều Chưa Nói
Đức Phúc - Cũng Đành Thôi
Freaky - Ngày Hôm Nay Anh Thế Nào
Tùng TeA - Già Cùng Nhau Là Được
Hiya - Em Có Nhớ Anh Không ?
Darki - CẢM ƠN VÌ ĐÃ YÊU - Suy Version
1nG - Ẩn Ý
Shiki - 1000 Ánh Mắt
W/N - 2 4
Nguyên - Đừng Khóc
1nG - Tâm Ý
Will - Nơi Ta Chờ Em (Em Chưa 18 Original Soundtrack)
Bảo Anh - Từng Là Của Nhau
Hải Đăng Doo - Chuyện Chúng Ta Sau Này
B Ray - Bản Nhạc Cuối (Cho Em)
Nguyễn Minh Xuân Ái - Là Từ Lúc - since
JustaTee - Cơn Mưa Cuối
AMEE - thay mọi cô gái yêu anh
Bích Phương - em bỏ hút thuốc chưa (feat. traitimtrongvang)
Tùng TeA - Mây Lang Thang
Binz - Cho Mình Em
DucMinh - Ngủ sớm đi em
PAR SG - Lý Do Nào Để Quay Lại Với Nhau
Luxuyen - Đó Chỉ Là Thành Phố Của Anh
SIVAN - Để Dành Khi Thức Giấc
Ronboogz - Khi Mà
PAR SG - whatever happens, happens
PAR SG - anh noi roi ma
Puppy - Quen Di Em La Ai
Dick - Anh Đã Lớn Hơn Thế Nhiều
Dfoxie37 - anh muốn bỏ thuốc
AI DA BEN EM |Curly
U made my day (rmx) - GUA ft. $uno
kidsai - LOVELY ft. Left Hand
phù thuỷ stonie - yêu vào là suy / uynsuy (lần cuối)
FALLINLUV - Anga` (ft Blaipoy Mìcay)
Tonion - Aquafina
Neero Voi - Love Step【prod.Kuttara Neru】
notgoodenough - BOI VI CO EM
young toots - pickupurphone | ngô & nghiêm (unreleased)
(SOLD) (Open Verse) Limitlxss - Chơi (Inbox for price)
tim anh khong phai tro choi ( prod 2pillz ) - Flymingo x minhxuf
Icy Nirvana - ysl.
Bluetato - D.I.T 3 ( Prod. Gosha )
lil cây zừa - kỷ niệm toác
Scarf On My Head - Left Hand (MOVART 2)
GREED - Kewwi X Liz Panda
Hoàng Tôn - Sex You Up (Main Version)
MATDAY - $tinger X huydua
OverFlow - T.Reaper (Prod. Raz)
PHONG CÁCH - MCK ( PROD. LOPE PHAM ) | OPEN VERSE
Dae Huyn - ANH IU EM VAILONE  Dũn featTrangMy
Ngoc Nghech 122 - Enkey47
Badman - Don Raemo
CHRISTMAS LOVE - tuanbinh ft. Viet4real
destiny - manh x chilly
EM ĐƯA ANH VÀO VIBE (KRIX REMIX) - J.SROURE, KAERI, MAXIE, BILLIOS
Big Q - "Chúng Ta" ft.  Yang E, TWOrion & DXSE
Dreazy - Call me ft. (MADDOG)
NILLIK - WOKE UP IN THE HEAVEN
nƠi TìNh YÊu bỐc ĐầU -  Ccmk x G Rose
ROCKVIBES - DESOLATE (Originality)
Maxine - "Roi minh lai yeu"
BLING BLING - NOS (21)
Koe - Smk(demo)-Tofu / Frame2frame
Dangrangto - Slow Dance (1980s Ver.) (Prod. MVrc)
Lit & Then - Low Hope
Em Có Cần? - Taylor x MEDODY (Prod. Roko Tensei & GC)
whereisfliedkid - what's u sayin
Limitlxss - vi vu trên con xe bò tót(snippet)
MOODLINE - Dewie (Prod. Samzbeats)
Not The Same / Dewie
10. Love Letter - Left Hand✰ & Lil Doc ft. $ativa, Leily
A tủne - -4°- Atủne x YungMean
Don Lenne Me - Hangoku
ANH CHI MUON DAM SAY | THIENVU
Có một trái tim băng - THIENVU
Chết Inside - slick x fishy
anh khong tin - lil chiều tím ft ???

